12,5,6,15,14,15,12,5,5,6
10,14,9,5,0,5,3,15,15,10
10,10,15,15,10,15,15,14,15,10
10,10,12,4,1,4,5,3,15,10
10,10,9,2,15,10,15,15,15,10
10,8,7,10,15,10,15,15,15,10
10,10,12,1,5,1,5,7,15,11
10,10,10,15,15,15,15,15,15,15
10,11,8,5,6,15,12,5,5,6
9,5,3,15,9,5,3,15,15,11
